1111111111111
1PE10000000C1
1000011111001
1000110C00001
1111111111111