11111111111111111111111111
10000000000000000000000001
10000010000000000000000001
10000010000000000000000001
10E00011100000000000000001
10000010000000000000000001
10000000000000000000000001
10P00000000000000000000001
10000000000000000000000001
10000000000000000000000001
10000000000000001110000001
10000000000000001000000001
11111111111111111111111111
